NO ./bonus/texture/the_north.png
SO ./bonus/texture/the_south.png
WE ./bonus/texture/the_west.png
EA ./bonus/texture/the_east.png

F 96,228,238
C 176,76,0

1111111111111111111111111
1000000W00000000000000001
1001101001110000000000001
100100000000000000000000111111111
111101111011000001110000000000001
100000000011000001110101111111111
11110111101111011100000010001
11100111111111011101010010001
11000000110001011100000010001
10000000000011001100000010001
100000000000010000010100100011
110000011101010111110100000011
11100111 1110101 101111010001
11111111 1111111 111111111111