NO ./mand/texture/the_north.png
SO ./mand/texture/the_south.png
WE ./mand/texture/the_west.png
EA ./mand/texture/the_east.png

F 0,225,225
C 32,32,32

        1111111111111111111111111
        1000010100110010010010001
        1011010001110010000010001
        1000010100000000010000001
111111111011010101110010010010001
100000000011000001110111111011111
11110111111111011100000010001
11110111111111011111101110001
11000100110101011100000010001
10000100000100000W000000000001
100001000000000001101010110001
110000011101010111110111100111
11110111 1110101 101111010001
11111111 1111111 111111111111
