NO ./mand/texture/the_north.png
SO ./mand/texture/the_south.png
WE ./mand/texture/the_west.png
EA ./mand/texture/the_east.png

F 96,228,238
C 176,76,110

11111111111111111111111111
1111111111111111 111111111
100000000000011 1 11000011
1001101D1D11011 1 11000011
100100000000011 1 11000011111111
1111011110110011 1110000000000001
111101111011001111110000000000001
10000000011000001110101111111111
111000000000000000000000000001
111000000000000000000000000001
110000000000000000000000000001
1N0000000000000000000000000001
1000000000000000000000000000011
110000001000000010000000000011
11100111 1110101 101111010001
11111111 1111111 111111111111