NO ./mand/texture/the_north.png
SO ./mand/texture/the_south.png
WE ./mand/texture/the_west.png
EA ./mand/texture/the_east.png

F 96,228,238
C 176,76,110

111111111111111111111111
10000000000000000000000011
1001101D1D110000000000001
10010000000000000000000011111111
1111011110110000011100000000000W1
10000000011000001110101111111111
11110111101111011100000010001
11100111111110011101010010001
11000000110001011100000010001
10000000000011001100000010001
100000000000010000010100100011
110000011101010111110100000011
11100111 1110101 101111010001
11111111 1111111 111111111111