NO ./bonus/texture/the_north.png
SO ./bonus/texture/the_south.png
WE ./bonus/texture/the_west.png
EA ./bonus/texture/the_east.png

F 0,225,225
C 32,32,32

        1111111111111111111111111
        1000010100110010010010001
        1011D10D01110010000010001
        10000101000000D00100D0001
111111111011010101110010010010001
100000000011000D01110111111D11111
11110111111111D11100000010001
1111D1111111110111111D1110001
1100010011D101011100000010001
10000100000100000W000000000001
10000100000000000110101D110001
11000001110101D111110111100111
11110111 1110101 101111010001
11111111 1111111 111111111111
